neighborhood_code,neighborhood_name,postal_code,postal_area,postal_code_m2,Total,Men,Women,population_density_km2,restaurant_count
101,København,1050,København K,39053,20,10,10,512.1245486902415,16
101,København,1051,København K,55643,399,191,208,7170.713297270097,28
101,København,1052,København K,6563,421,204,217,64147.49352430291,2
101,København,1053,København K,2434,404,181,223,165981.92276088742,2
101,København,1054,København K,4953,392,201,191,79143.9531597012,1
101,København,1055,København K,5449,340,165,175,62396.77004955038,1
101,København,1056,København K,21601,51,27,24,2361.001805471969,0
101,København,1057,København K,11275,300,144,156,26607.538802660754,4
101,København,1058,København K,79437,213,103,110,2681.370142376978,3
101,København,1059,København K,4897,19,9,10,3879.9264856034306,0
101,København,1061,København K,7315,10,3,7,1367.0539986329459,1
101,København,1062,København K,2230,19,7,12,8520.179372197308,1
101,København,1063,København K,3465,126,61,65,36363.63636363636,0
101,København,1064,København K,984,7,4,3,7113.821138211381,0
101,København,1065,København K,2823,25,15,10,8855.82713425434,0
101,København,1066,København K,4411,53,26,27,12015.416005440944,1
101,København,1067,København K,13995,107,58,49,7645.587709896391,3
101,København,1068,København K,577,37,21,16,64124.78336221837,0
101,København,1069,København K,7574,40,21,19,5281.225244256668,3
101,København,1070,København K,6119,61,33,28,9968.949174701747,3
101,København,1071,København K,949,66,33,33,69546.89146469969,1
101,København,1072,København K,2374,4,2,2,1684.9199663016009,0
101,København,1073,København K,1365,6,4,2,4395.604395604396,1
101,København,1074,København K,16536,23,13,10,1390.9046927914853,3
101,København,1100,København K,2165,29,20,9,13394.919168591225,12
101,København,1101,København K,7128,80,34,46,11223.34455667789,6
101,København,1102,København K,7173,2,1,1,278.82336539802037,0
101,København,1103,København K,13060,4,3,1,306.2787136294028,2
101,København,1104,København K,6151,86,38,48,13981.466428223053,5
101,København,1105,København K,4164,0,0,0,0.0,0
101,København,1106,København K,12192,15,10,5,1230.3149606299212,2
101,København,1107,København K,3457,98,53,45,28348.27885449812,10
101,København,1110,København K,4015,105,53,52,26151.9302615193,2
101,København,1111,København K,2896,76,33,43,26243.093922651933,0
101,København,1112,København K,22144,175,93,82,7902.817919075144,8
101,København,1113,København K,15950,64,33,31,4012.5391849529783,1
101,København,1114,København K,14937,108,53,55,7230.36754368347,0
101,København,1115,København K,1880,35,17,18,18617.021276595744,0
101,København,1116,København K,3566,53,25,28,14862.591138530566,3
101,København,1117,København K,4329,76,41,35,17556.017556017556,3
101,København,1118,København K,7937,8,4,4,1007.9375078745119,4
101,København,1119,København K,10327,75,41,34,7262.515735450761,6
101,København,1123,København K,147000,890,431,459,6054.421768707483,24
101,København,1124,København K,10481,157,72,85,14979.486690201316,1
101,København,1125,København K,2849,29,15,14,10179.01017901018,0
101,København,1126,København K,3811,8,1,7,2099.186565205983,0
101,København,1127,København K,5514,82,38,44,14871.236851650345,2
101,København,1128,København K,1564,29,11,18,18542.19948849105,1
101,København,1129,København K,4048,61,25,36,15069.169960474306,0
101,København,1130,København K,6223,115,59,56,18479.832878033103,2
101,København,1131,København K,2020,35,19,16,17326.732673267325,0
101,København,1150,København K,26616,282,160,122,10595.130748422001,4
101,København,1151,København K,6284,100,54,46,15913.430935709739,3
101,København,1152,København K,3774,74,45,29,19607.843137254902,1
101,København,1153,København K,2684,75,35,40,27943.368107302533,4
101,København,1154,København K,7762,121,62,59,15588.765782014945,14
101,København,1156,København K,821,23,13,10,28014.616321559075,0
101,København,1157,København K,5619,95,52,43,16906.922940024917,2
101,København,1158,København K,3417,4,1,3,1170.617500731636,0
101,København,1159,København K,9175,335,176,159,36512.26158038147,15
101,København,1160,København K,14097,34,15,19,2411.860679577215,2
101,København,1161,København K,9113,34,20,14,3730.9338307911776,3
101,København,1164,København K,9034,45,19,26,4981.182200575603,4
101,København,1165,København K,44310,262,141,121,5912.886481606861,13
101,København,1166,København K,10113,11,7,4,1087.7088895481063,0
101,København,1169,København K,7504,297,146,151,39578.89125799573,1
101,København,1170,København K,922,15,1,14,16268.980477223427,0
101,København,1171,København K,13420,341,158,183,25409.83606557377,19
101,København,1172,København K,9179,111,49,62,12092.8205686894,3
101,København,1173,København K,5076,161,71,90,31717.888100866825,0
101,København,1174,København K,8209,179,87,92,21805.335607260327,4
101,København,1175,København K,6538,30,16,14,4588.5591924135815,4
101,København,1200,København K,8258,55,30,25,6660.20828287721,3
101,København,1201,København K,13972,100,49,51,7157.1714858288005,11
101,København,1202,København K,10414,43,23,20,4129.057038601883,3
101,København,1203,København K,4175,65,30,35,15568.862275449103,3
101,København,1204,København K,5408,46,22,24,8505.917159763314,3
101,København,1205,København K,4123,58,29,29,14067.426631093864,2
101,København,1206,København K,1087,34,14,20,31278.748850045995,0
101,København,1207,København K,5665,47,22,25,8296.557811120918,2
101,København,1208,København K,5025,156,83,73,31044.776119402984,8
101,København,1209,København K,11285,152,76,76,13469.206911829862,3
101,København,1210,København K,2904,119,51,68,40977.96143250689,3
101,København,1211,København K,1621,77,50,27,47501.54225786551,1
101,København,1212,København K,16649,0,0,0,0.0,0
101,København,1218,København K,90371,19,12,7,210.2444368215467,1
101,København,1219,København K,34293,14,8,6,408.2465809348847,1
101,København,1220,København K,40227,119,65,54,2958.212146071047,4
101,København,1250,København K,55705,101,57,44,1813.122699937169,3
101,København,1251,København K,8851,66,36,30,7456.784544119309,0
101,København,1253,København K,98120,656,333,323,6685.690990623726,5
101,København,1254,København K,14145,241,120,121,17037.822552138565,1
101,København,1255,København K,10492,99,56,43,9435.760579489135,4
101,København,1256,København K,48744,412,202,210,8452.322337108157,2
101,København,1257,København K,22697,17,8,9,748.997664889633,0
101,København,1259,København K,72700,0,0,0,0.0,2
101,København,1260,København K,119000,370,196,174,3109.2436974789916,6
101,København,1261,København K,17783,73,33,40,4105.04414328291,2
101,København,1263,København K,42201,209,112,97,4952.489277505272,8
101,København,1264,København K,2342,1313,660,653,560631.9385140905,24
101,København,1265,København K,44597,131,66,65,2937.417315066036,0
101,København,1266,København K,10486,85,39,46,8106.046156780469,0
101,København,1267,København K,1785,73,34,39,40896.358543417366,0
101,København,1268,København K,5633,53,27,26,9408.840759808272,1
101,København,1270,København K,39879,133,63,70,3335.0886431455156,1
101,København,1271,København K,3178,14,8,6,4405.286343612335,0
101,København,1300,København K,41481,493,240,253,11884.959378992793,10
101,København,1302,København K,17842,946,421,525,53020.961775585696,12
101,København,1303,København K,3870,113,54,59,29198.966408268734,2
101,København,1304,København K,46392,485,208,277,10454.388687704775,1
101,København,1306,København K,26899,648,310,338,24090.11487415889,3
101,København,1307,København K,94968,1681,691,990,17700.699182882654,11
101,København,1308,København K,19032,295,137,158,15500.21017234132,1
101,København,1309,København K,4466,159,64,95,35602.32870577698,0
101,København,1310,København K,25275,678,322,356,26824.92581602374,1
101,København,1311,København K,13205,390,175,215,29534.26732298372,0
101,København,1312,København K,1368,21,9,12,15350.877192982456,0
101,København,1313,København K,18194,264,131,133,14510.278113663846,0
101,København,1314,København K,6653,97,41,56,14579.888771982563,0
101,København,1315,København K,1014,54,24,30,53254.43786982249,0
101,København,1316,København K,15935,256,135,121,16065.265139629744,0
101,København,1317,København K,8839,37,20,17,4185.993890711619,0
101,København,1318,København K,4805,53,25,28,11030.176899063476,0
101,København,1319,København K,8319,262,109,153,31494.169972352447,0
101,København,1320,København K,7299,83,48,35,11371.420742567476,0
101,København,1321,København K,10105,28,20,8,2770.90549233053,0
101,København,1322,København K,8155,132,85,47,16186.388718577558,0
101,København,1323,København K,7078,29,19,10,4097.202599604408,0
101,København,1324,København K,7873,126,80,46,16004.064524323638,0
101,København,1325,København K,7131,122,82,40,17108.399943906887,0
101,København,1326,København K,5085,48,28,20,9439.52802359882,0
101,København,1327,København K,6662,33,17,16,4953.467427199039,0
101,København,1328,København K,3836,55,35,20,14337.851929092805,0
101,København,1329,København K,7872,23,16,7,2921.7479674796746,0
101,København,1350,København K,116000,316,132,184,2724.137931034483,3
101,København,1352,København K,11000,485,220,265,44090.909090909096,0
101,København,1353,København K,144000,86,35,51,597.2222222222223,0
101,København,1354,København K,9229,531,244,287,57536.027738649915,0
101,København,1355,København K,13978,418,187,231,29904.13506939476,0
101,København,1356,København K,13055,159,69,90,12179.241669858291,0
101,København,1357,København K,45773,154,72,82,3364.428811744915,0
101,København,1358,København K,63509,393,199,194,6188.099324505189,6
101,København,1359,København K,15428,245,120,125,15880.217785843919,3
101,København,1360,København K,47037,746,350,396,15859.855007759848,16
101,København,1361,København K,35900,327,168,159,9108.635097493036,8
101,København,1362,København K,19344,379,199,180,19592.638544251447,5
101,København,1363,København K,17142,504,261,243,29401.470073503675,5
101,København,1364,København K,95799,984,480,504,10271.505965615508,8
101,København,1365,København K,3916,211,96,115,53881.511746680284,0
101,København,1366,København K,47525,1308,640,668,27522.356654392428,6
101,København,1367,København K,3914,363,168,195,92743.99591211037,0
101,København,1368,København K,12350,329,158,171,26639.676113360325,3
101,København,1369,København K,35359,194,102,92,5486.580502842275,1
101,København,1370,København K,77771,762,382,380,9797.996682568051,0
101,København,1400,København K,40569,419,215,204,10328.083019053956,10
101,København,1401,København K,97238,1026,475,551,10551.43051070569,18
101,København,1402,København K,82674,304,154,150,3677.0931610905486,0
101,København,1403,København K,15766,8,4,4,507.42103260180136,0
101,København,1406,København K,4161,42,26,16,10093.727469358328,1
101,København,1407,København K,46075,134,64,70,2908.301682040152,1
101,København,1408,København K,38507,613,302,311,15919.183525073364,6
101,København,1410,København K,1684,29,16,13,17220.902612826605,1
101,København,1411,København K,44173,524,280,244,11862.449912842687,3
101,København,1412,København K,2873,36,23,13,12530.455969369996,0
101,København,1413,København K,4603,88,53,35,19117.96654355855,0
101,København,1414,København K,20181,242,119,123,11991.477131955799,2
101,København,1415,København K,33157,719,340,379,21684.712127152638,2
101,København,1416,København K,15737,473,209,264,30056.554616508864,4
101,København,1417,København K,2938,85,38,47,28931.245745405038,0
101,København,1418,København K,2218,263,117,146,118575.29305680795,0
101,København,1419,København K,5935,19,10,9,3201.3479359730413,0
101,København,1420,København K,31910,665,303,362,20839.862112190534,5
101,København,1421,København K,1648,35,18,17,21237.864077669903,0
101,København,1422,København K,63893,852,404,448,13334.794108900818,3
101,København,1423,København K,3713,94,44,50,25316.45569620253,0
101,København,1424,København K,28942,390,179,211,13475.226314698362,1
101,København,1425,København K,4488,266,128,138,59269.16221033868,0
101,København,1426,København K,16344,145,71,74,8871.75721977484,1
101,København,1427,København K,8075,218,111,107,26996.9040247678,0
101,København,1428,København K,5553,458,229,229,82477.93985233207,0
101,København,1429,København K,9472,518,222,296,54687.5,1
101,København,1430,København K,15209,405,180,225,26628.969688999932,0
101,København,1431,København K,0,0,0,0,,0
101,København,1432,København K,1939000,2185,1114,1071,1126.8695203713253,35
101,København,1433,København K,92605,0,0,0,0.0,1
101,København,1434,København K,49475,140,73,67,2829.711975745326,0
101,København,1435,København K,44273,103,54,49,2326.4743749011814,0
101,København,1436,København K,179000,498,231,267,2782.122905027933,0
101,København,1437,København K,176000,444,212,232,2522.727272727273,1
101,København,1439,København K,285000,159,77,82,557.8947368421053,2
101,København,1440,København K,320000,721,379,342,2253.125,5
101,København,1441,København K,203000,156,82,74,768.4729064039408,2
101,København,1450,København K,5610,55,31,24,9803.921568627451,1
101,København,1451,København K,7133,72,26,46,10093.929622879574,0
101,København,1452,København K,20655,125,60,65,6051.8034374243525,2
101,København,1453,København K,5323,332,173,159,62370.84350929927,8
101,København,1454,København K,8905,155,70,85,17405.951712521055,6
101,København,1455,København K,10172,364,174,190,35784.50648839953,13
101,København,1456,København K,10646,127,62,65,11929.363141085854,2
101,København,1457,København K,20660,6,3,3,290.41626331074536,7
101,København,1458,København K,6994,69,31,38,9865.59908492994,3
101,København,1459,København K,3526,46,19,27,13045.944412932502,11
101,København,1460,København K,5828,63,32,31,10809.883321894304,4
101,København,1462,København K,1486,85,47,38,57200.53835800808,1
101,København,1463,København K,4258,26,15,11,6106.153123532175,1
101,København,1464,København K,3098,8,5,3,2582.3111684958035,0
101,København,1466,København K,6033,110,60,50,18233.05154980938,5
101,København,1467,København K,3270,69,32,37,21100.91743119266,5
101,København,1468,København K,13512,119,58,61,8806.986382474837,1
101,København,1470,København K,21269,76,9,67,3573.2756594104094,0
101,København,1471,København K,12112,40,20,20,3302.5099075297226,0
101,København,1472,København K,15630,65,31,34,4158.669225847729,0
101,København,1473,København K,7386,24,14,10,3249.390739236393,1
101,København,1500,København V,0,0,0,0,,0
101,København,1550,København V,45567,12,9,3,263.3484758706959,6
101,København,1551,København V,6405,0,0,0,0.0,1
101,København,1552,København V,26563,387,191,196,14569.137522117231,7
101,København,1553,København V,155000,418,210,208,2696.7741935483873,4
101,København,1554,København V,4253,0,0,0,0.0,5
101,København,1555,København V,7512,18,12,6,2396.1661341853037,2
101,København,1556,København V,10004,39,17,22,3898.4406237504995,0
101,København,1557,København V,5787,86,41,45,14860.895109728703,0
101,København,1558,København V,3378,60,30,30,17761.989342806395,0
101,København,1559,København V,81336,30,16,14,368.84036588964295,0
101,København,1560,København V,168000,5,5,0,29.76190476190476,28
101,København,1561,København V,263000,714,362,352,2714.828897338403,8
101,København,1562,København V,20639,31,13,18,1502.0107563350937,0
101,København,1563,København V,2264,17,9,8,7508.833922261484,0
101,København,1564,København V,10307,122,56,66,11836.615892112157,1
101,København,1568,København V,15207,65,33,32,4274.347340040771,1
101,København,1569,København V,4467,92,46,46,20595.477949406762,0
101,København,1570,København V,26945,0,0,0,0.0,4
101,København,1571,København V,13313,43,19,24,3229.9256365958086,0
101,København,1572,København V,6638,113,57,56,17023.199758963543,0
101,København,1573,København V,6905,357,185,172,51701.66545981173,1
101,København,1574,København V,10485,82,40,42,7820.696232713401,0
101,København,1575,København V,6175,24,12,12,3886.6396761133606,0
101,København,1576,København V,20181,60,31,29,2973.0935037906943,0
101,København,1577,København V,280000,665,416,249,2375.0,19
101,København,1600,København V,7583,29,15,14,3824.343927205591,0
101,København,1601,København V,199000,515,259,256,2587.939698492462,0
101,København,1602,København V,51014,29,12,17,568.471400007841,1
101,København,1603,København V,4136,73,31,42,17649.90328820116,0
101,København,1605,København V,2592,35,26,9,13503.086419753086,0
101,København,1606,København V,26302,219,110,109,8326.36301421945,4
101,København,1608,København V,10407,31,11,20,2978.7642932641493,2
101,København,1609,København V,16215,2,2,0,123.34258402713537,8
101,København,1610,København V,154000,647,329,318,4201.298701298701,8
101,København,1611,København V,18109,0,0,0,0.0,0
101,København,1614,København V,6047,31,18,13,5126.509012733587,0
101,København,1615,København V,2916,222,109,113,76131.68724279835,1
101,København,1616,København V,4028,127,53,74,31529.294935451835,0
101,København,1617,København V,5215,143,61,82,27420.901246404603,1
101,København,1618,København V,17215,281,142,139,16322.974150450187,0
101,København,1619,København V,3332,142,67,75,42617.04681872749,6
101,København,1620,København V,66324,3160,1597,1563,47644.89475906158,91
101,København,1621,København V,15019,113,57,56,7523.803182635329,0
101,København,1622,København V,1507,192,84,108,127405.4412740544,0
101,København,1623,København V,6864,134,66,68,19522.14452214452,0
101,København,1624,København V,6999,168,84,84,24003.42906129447,0
101,København,1631,København V,9853,209,100,109,21211.813660813965,0
101,København,1632,København V,1975,142,74,68,71898.73417721518,1
101,København,1633,København V,10965,107,53,54,9758.321933424531,0
101,København,1634,København V,4776,175,83,92,36641.54103852597,1
101,København,1635,København V,15606,151,78,73,9675.765731129053,3
101,København,1650,København V,29825,1506,746,760,50494.55155071249,37
101,København,1651,København V,8709,340,183,157,39040.07348719715,2
101,København,1652,København V,4989,273,138,135,54720.38484666265,2
101,København,1653,København V,17718,247,127,120,13940.625352748617,4
101,København,1654,København V,13015,422,212,210,32424.126008451785,3
101,København,1655,København V,16149,524,261,263,32447.82958697133,5
101,København,1656,København V,18735,708,344,364,37790.232185748595,4
101,København,1657,København V,13288,522,243,279,39283.5641180012,0
101,København,1658,København V,25049,868,403,465,34652.08191943791,1
101,København,1659,København V,662,50,27,23,75528.70090634441,1
101,København,1660,København V,20033,714,346,368,35641.192033145315,0
101,København,1661,København V,15381,437,206,231,28411.67674403485,0
101,København,1662,København V,25223,958,453,505,37981.20762795861,2
101,København,1663,København V,37385,1556,712,844,41620.97097766484,7
101,København,1664,København V,7872,103,52,51,13084.349593495934,0
101,København,1665,København V,43528,1260,626,634,28946.88476383018,4
101,København,1666,København V,41215,672,344,328,16304.743418658254,1
101,København,1667,København V,3899,165,73,92,42318.543216209284,0
101,København,1668,København V,12820,435,222,213,33931.357254290175,2
101,København,1669,København V,10131,737,358,379,72747.0141150923,2
101,København,1670,København V,33522,397,198,199,11842.96879661118,10
101,København,1671,København V,14226,540,248,292,37958.667229017294,1
101,København,1672,København V,3258,153,81,72,46961.325966850825,0
101,København,1673,København V,3430,144,65,79,41982.50728862974,0
101,København,1674,København V,87471,1251,589,662,14301.88290976438,15
101,København,1675,København V,3846,122,60,62,31721.26885075403,0
101,København,1676,København V,11248,353,184,169,31383.35704125178,0
101,København,1677,København V,7181,144,69,75,20052.91742097201,0
101,København,1700,København V,87959,582,297,285,6616.719153241852,10
101,København,1701,København V,3396,125,69,56,36808.00942285041,0
101,København,1702,København V,5194,147,68,79,28301.88679245283,0
101,København,1703,København V,3495,193,94,99,55221.745350500714,0
101,København,1704,København V,66489,117,65,52,1759.6895727112753,0
101,København,1705,København V,137000,933,468,465,6810.218978102189,3
101,København,1706,København V,4524,139,76,63,30725.02210433245,0
101,København,1707,København V,5120,60,31,29,11718.749999999998,0
101,København,1708,København V,4361,200,99,101,45861.04104563173,0
101,København,1709,København V,32175,695,339,356,21600.6216006216,2
101,København,1710,København V,8809,22,12,10,2497.445794074242,0
101,København,1715,København V,19010,0,0,0,0.0,11
101,København,1717,København V,19725,241,118,123,12217.997465145754,0
101,København,1718,København V,12968,627,309,318,48349.78408389883,0
101,København,1719,København V,10705,598,274,324,55861.746847267634,0
101,København,1720,København V,131000,1975,963,1012,15076.335877862595,7
101,København,1721,København V,21694,895,432,463,41255.64672259611,5
101,København,1722,København V,7923,489,246,243,61719.0458159788,1
101,København,1723,København V,8849,105,50,55,11865.747542095152,1
101,København,1724,København V,10449,114,54,60,10910.134941142693,0
101,København,1725,København V,30729,344,169,175,11194.63698786163,1
101,København,1726,København V,25219,446,216,230,17685.078710496055,0
101,København,1727,København V,7394,352,156,196,47606.16716256424,0
101,København,1728,København V,4415,273,135,138,61834.65458663647,0
101,København,1729,København V,3699,213,110,103,57583.1305758313,0
101,København,1730,København V,1781,164,83,81,92083.09938236946,0
101,København,1731,København V,2912,92,46,46,31593.40659340659,0
101,København,1732,København V,1752,119,51,68,67922.37442922374,0
101,København,1733,København V,1068,108,59,49,101123.59550561798,0
101,København,1734,København V,4483,119,56,63,26544.724514833815,1
101,København,1735,København V,2723,213,110,103,78222.54865956664,0
101,København,1736,København V,2710,191,79,112,70479.70479704796,0
101,København,1737,København V,3560,242,122,120,67977.52808988764,0
101,København,1738,København V,4898,222,110,112,45324.62229481422,0
101,København,1739,København V,3251,88,47,41,27068.594278683482,0
101,København,1748,København V,0,0,0,0,,0
101,København,1749,København V,9280,224,118,106,24137.931034482757,0
101,København,1750,København V,31491,820,408,412,26039.18579911721,4
101,København,1751,København V,6625,413,201,212,62339.622641509435,4
101,København,1752,København V,9665,331,166,165,34247.28401448525,0
101,København,1753,København V,12545,81,42,39,6456.755679553607,0
101,København,1754,København V,3631,581,273,308,160011.0162489672,0
101,København,1755,København V,1256,104,53,51,82802.54777070064,0
101,København,1756,København V,9633,424,200,224,44015.36385342054,0
101,København,1757,København V,16996,174,80,94,10237.702988938574,0
101,København,1758,København V,3123,321,165,156,102785.78290105668,0
101,København,1759,København V,3487,27,14,13,7743.045597935187,0
101,København,1760,København V,24500,678,326,352,27673.4693877551,3
101,København,1761,København V,10890,382,175,207,35078.05325987144,0
101,København,1762,København V,5731,401,178,223,69970.33676496249,0
101,København,1763,København V,10988,552,251,301,50236.62176920277,0
101,København,1764,København V,4391,269,146,123,61261.671601002054,0
101,København,1765,København V,15941,156,74,82,9786.086192836083,0
101,København,1766,København V,5377,46,21,25,8554.95629533197,0
101,København,1770,København V,9302,191,96,95,20533.218662653195,0
101,København,1771,København V,1949,50,21,29,25654.181631605952,0
101,København,1772,København V,1607,46,18,28,28624.766645924083,0
101,København,1773,København V,2003,58,32,26,28956.565152271593,0
101,København,1774,København V,17725,130,67,63,7334.273624823695,0
101,København,1775,København V,1314,47,27,20,35768.64535768645,0
101,København,1777,København V,8698,132,62,70,15175.902506323295,0
101,København,1799,København V,324000,4229,2117,2112,13052.469135802468,16
101,København,2100,København ø,9100000,91554,44085,47469,10060.87912087912,263
101,København,2150,Nordhavn,2917000,4006,2013,1993,1373.3287624271513,28
101,København,2200,København N,3941000,77132,36780,40352,19571.682314133468,272
101,København,2300,København S,29400000,153669,75664,78005,5226.836734693878,320
101,København,2400,København NV,7000000,54410,27010,27400,7772.857142857143,96
101,København,2450,København SV,9100000,39490,20034,19456,4339.56043956044,59
101,København,2500,Valby,7600000,65522,32588,32934,8621.315789473685,131
101,København,2610,Rødovre,12300000,66,38,28,5.365853658536585,66
101,København,2700,Brønshøj,8200000,45950,22892,23058,5603.658536585366,72
101,København,2720,Vanløse,5200000,33160,16377,16783,6376.923076923077,71
101,København,2770,Kastrup,59600000,119,61,58,1.9966442953020134,123
101,København,2860,Søborg,13200000,236,132,104,17.87878787878788,60
101,København,2900,Hellerup,6800000,3786,1771,2015,556.7647058823529,66
147,Frederiksberg,1800,Frederiksberg C,6192,717,362,355,115794.57364341085,12
147,Frederiksberg,1801,Frederiksberg C,14234,380,177,203,26696.641843473375,0
147,Frederiksberg,1802,Frederiksberg C,21785,231,115,116,10603.626348404867,0
147,Frederiksberg,1803,Frederiksberg C,3363,90,42,48,26761.819803746654,0
147,Frederiksberg,1804,Frederiksberg C,7673,264,120,144,34406.3599635084,0
147,Frederiksberg,1805,Frederiksberg C,1691,27,10,17,15966.883500887048,0
147,Frederiksberg,1806,Frederiksberg C,18456,189,86,103,10240.572171651495,1
147,Frederiksberg,1807,Frederiksberg C,10944,203,97,106,18548.976608187135,0
147,Frederiksberg,1808,Frederiksberg C,15613,117,57,60,7493.7552039966695,0
147,Frederiksberg,1809,Frederiksberg C,11859,232,105,127,19563.20094443039,0
147,Frederiksberg,1810,Frederiksberg C,29238,771,379,392,26369.792735481224,0
147,Frederiksberg,1811,Frederiksberg C,16030,52,27,25,3243.917654398004,0
147,Frederiksberg,1812,Frederiksberg C,34500,465,215,250,13478.260869565216,0
147,Frederiksberg,1813,Frederiksberg C,24840,598,285,313,24074.074074074073,0
147,Frederiksberg,1814,Frederiksberg C,18822,448,222,226,23801.933907129955,0
147,Frederiksberg,1815,Frederiksberg C,11570,243,116,127,21002.592912705273,0
147,Frederiksberg,1816,Frederiksberg C,7196,153,73,80,21261.812117843245,1
147,Frederiksberg,1817,Frederiksberg C,4640,453,209,244,97629.31034482758,0
147,Frederiksberg,1818,Frederiksberg C,7853,140,73,67,17827.581815866546,0
147,Frederiksberg,1819,Frederiksberg C,2791,162,82,80,58043.71193120745,2
147,Frederiksberg,1820,Frederiksberg C,85971,1379,669,710,16040.292656826137,12
147,Frederiksberg,1822,Frederiksberg C,1724,89,37,52,51624.12993039443,0
147,Frederiksberg,1823,Frederiksberg C,3940,77,38,39,19543.147208121827,0
147,Frederiksberg,1824,Frederiksberg C,15255,351,184,167,23008.849557522124,0
147,Frederiksberg,1825,Frederiksberg C,12341,124,59,65,10047.808119277206,0
147,Frederiksberg,1826,Frederiksberg C,14714,174,81,93,11825.472339268725,0
147,Frederiksberg,1827,Frederiksberg C,19468,346,164,182,17772.755290733512,0
147,Frederiksberg,1828,Frederiksberg C,8395,283,130,153,33710.541989279336,0
147,Frederiksberg,1829,Frederiksberg C,26622,318,164,154,11945.007888212756,1
147,Frederiksberg,1850,Frederiksberg C,89561,1869,916,953,20868.45836915622,20
147,Frederiksberg,1851,Frederiksberg C,14905,423,193,230,28379.738342837973,0
147,Frederiksberg,1852,Frederiksberg C,20562,203,104,99,9872.58048827935,0
147,Frederiksberg,1853,Frederiksberg C,18272,354,161,193,19373.905429071805,1
147,Frederiksberg,1854,Frederiksberg C,5988,278,126,152,46426.18570474282,0
147,Frederiksberg,1855,Frederiksberg C,11664,418,197,221,35836.76268861454,0
147,Frederiksberg,1856,Frederiksberg C,5961,111,58,53,18621.036738802213,0
147,Frederiksberg,1857,Frederiksberg C,21810,62,30,32,2842.7326914259515,0
147,Frederiksberg,1860,Frederiksberg C,20737,222,116,106,10705.502242368713,0
147,Frederiksberg,1861,Frederiksberg C,12170,195,98,97,16023.007395234183,0
147,Frederiksberg,1862,Frederiksberg C,11290,131,62,69,11603.188662533215,0
147,Frederiksberg,1863,Frederiksberg C,6654,93,45,48,13976.555455365193,0
147,Frederiksberg,1864,Frederiksberg C,51637,616,277,339,11929.43044715998,1
147,Frederiksberg,1865,Frederiksberg C,1447,71,37,34,49067.03524533518,0
147,Frederiksberg,1866,Frederiksberg C,2167,183,92,91,84448.54637748038,1
147,Frederiksberg,1867,Frederiksberg C,2819,17,10,7,6030.507272082299,0
147,Frederiksberg,1868,Frederiksberg C,5420,268,134,134,49446.49446494465,0
147,Frederiksberg,1870,Frederiksberg C,139000,948,421,527,6820.143884892086,1
147,Frederiksberg,1871,Frederiksberg C,66262,631,311,320,9522.803416739609,2
147,Frederiksberg,1872,Frederiksberg C,1444,84,38,46,58171.745152354575,0
147,Frederiksberg,1873,Frederiksberg C,8142,38,20,18,4667.157946450504,0
147,Frederiksberg,1874,Frederiksberg C,33784,450,213,237,13319.914752545583,0
147,Frederiksberg,1875,Frederiksberg C,18872,234,113,121,12399.321746502756,0
147,Frederiksberg,1876,Frederiksberg C,20304,102,49,53,5023.640661938534,0
147,Frederiksberg,1877,Frederiksberg C,19995,50,26,24,2500.6251562890725,0
147,Frederiksberg,1878,Frederiksberg C,17723,85,36,49,4796.027760537156,0
147,Frederiksberg,1879,Frederiksberg C,59418,1537,768,769,25867.582214143862,22
147,Frederiksberg,1900,Frederiksberg C,36388,965,430,535,26519.7317797076,6
147,Frederiksberg,1901,Frederiksberg C,10710,33,20,13,3081.2324929971987,0
147,Frederiksberg,1902,Frederiksberg C,36166,818,389,429,22617.928441077256,1
147,Frederiksberg,1903,Frederiksberg C,39972,338,169,169,8455.91914340038,0
147,Frederiksberg,1904,Frederiksberg C,21599,774,375,399,35834.992360757446,0
147,Frederiksberg,1905,Frederiksberg C,20888,256,126,130,12255.840674071236,0
147,Frederiksberg,1906,Frederiksberg C,13230,143,70,73,10808.767951625094,0
147,Frederiksberg,1908,Frederiksberg C,12905,293,141,152,22704.37814800465,0
147,Frederiksberg,1909,Frederiksberg C,37660,784,343,441,20817.843866171002,0
147,Frederiksberg,1910,Frederiksberg C,20232,250,131,119,12356.662712534599,0
147,Frederiksberg,1911,Frederiksberg C,30430,397,194,203,13046.335852776865,3
147,Frederiksberg,1912,Frederiksberg C,7703,279,130,149,36219.65467999481,0
147,Frederiksberg,1913,Frederiksberg C,6455,221,99,122,34237.02556158017,0
147,Frederiksberg,1914,Frederiksberg C,3767,138,65,73,36633.92620122113,0
147,Frederiksberg,1915,Frederiksberg C,18707,330,165,165,17640.45544448602,0
147,Frederiksberg,1916,Frederiksberg C,6195,173,82,91,27925.746569814368,0
147,Frederiksberg,1917,Frederiksberg C,11917,128,63,65,10740.95829487287,0
147,Frederiksberg,1920,Frederiksberg C,21134,508,241,267,24037.09662155768,0
147,Frederiksberg,1921,Frederiksberg C,1565,74,36,38,47284.34504792332,0
147,Frederiksberg,1922,Frederiksberg C,13367,96,49,47,7181.86578888307,0
147,Frederiksberg,1923,Frederiksberg C,4279,224,103,121,52348.67959803693,0
147,Frederiksberg,1924,Frederiksberg C,14686,172,80,92,11711.834400108948,0
147,Frederiksberg,1925,Frederiksberg C,21137,40,19,21,1892.416142309694,0
147,Frederiksberg,1926,Frederiksberg C,16466,34,20,14,2064.860925543544,0
147,Frederiksberg,1927,Frederiksberg C,6341,58,31,27,9146.822267781106,0
147,Frederiksberg,1928,Frederiksberg C,8769,15,6,9,1710.5713308244951,0
147,Frederiksberg,1950,Frederiksberg C,26982,496,234,262,18382.625454006375,1
147,Frederiksberg,1951,Frederiksberg C,4248,162,78,84,38135.59322033898,0
147,Frederiksberg,1952,Frederiksberg C,6862,334,178,156,48673.85601865345,0
147,Frederiksberg,1953,Frederiksberg C,11743,419,199,220,35680.8311334412,0
147,Frederiksberg,1954,Frederiksberg C,33171,1166,534,632,35151.18627716982,1
147,Frederiksberg,1955,Frederiksberg C,17029,356,167,189,20905.514122966706,0
147,Frederiksberg,1956,Frederiksberg C,8407,363,174,189,43178.303794457,0
147,Frederiksberg,1957,Frederiksberg C,13936,392,179,213,28128.587830080367,0
147,Frederiksberg,1958,Frederiksberg C,85739,292,135,157,3405.6846942464927,7
147,Frederiksberg,1959,Frederiksberg C,18218,81,39,42,4446.152157207157,0
147,Frederiksberg,1960,Frederiksberg C,2690,515,249,266,191449.81412639405,3
147,Frederiksberg,1961,Frederiksberg C,9346,396,191,205,42371.067836507595,0
147,Frederiksberg,1962,Frederiksberg C,21237,217,109,108,10218.015727268446,0
147,Frederiksberg,1963,Frederiksberg C,8529,163,73,90,19111.267440497126,0
147,Frederiksberg,1964,Frederiksberg C,28342,460,208,252,16230.32954625644,0
147,Frederiksberg,1965,Frederiksberg C,3660,81,36,45,22131.147540983606,0
147,Frederiksberg,1966,Frederiksberg C,13652,242,114,128,17726.340462935834,0
147,Frederiksberg,1967,Frederiksberg C,17099,209,102,107,12222.937013860459,0
147,Frederiksberg,1970,Frederiksberg C,42650,522,251,271,12239.15592028136,4
147,Frederiksberg,1971,Frederiksberg C,6031,147,73,74,24374.067318852594,0
147,Frederiksberg,1972,Frederiksberg C,15483,377,181,196,24349.28631402183,0
147,Frederiksberg,1973,Frederiksberg C,23686,307,151,156,12961.242928312084,0
147,Frederiksberg,1974,Frederiksberg C,10106,24,12,12,2374.8268355432415,0
147,Frederiksberg,2000,Frederiksberg,6600000,71251,33507,37744,10795.606060606062,187
